10 10

1 8

1 2 3 2 2 1 2 2 1 1
1 0 0 0 0 9 0 0 0 1
1 0 0 0 1 0 0 0 0 1
1 0 0 0 1 0 0 0 0 1
1 4 0 0 1 0 0 0 0 2
1 0 0 0 4 0 0 0 0 2
1 0 0 0 0 0 0 0 0 1
1 0 1 0 0 0 0 0 0 1
1 0 1 0 0 0 0 0 0 1
1 1 1 1 1 1 1 1 1 1